11111111111111111111111
1C000000000000100000001
10000000000P0000000C001
1101110000111100C000001
1E00000000111100000S001
111111110001C100P000001
1000000000000100C000001
10C0000000000100E000001
1100001111111100000C001
1000C100000C00000000001
11111111111111111111111
